[
    {
        "name": "Map 1",
        "data": [
            [-1, -1, -1, -1, -1, -1, -1, -1],
            [-1, 0, 0, 0, 0, 4, 0, -1],
            [-1, 0, 0, 0, 0, 4, 0, -1],
            [-1, 1, 1, 0, 0, 4, 0, -2],
            [-1, 0, 0, 0, 3, 0, 0, -1],
            [-1, 0, 0, 0, 3, 2, 2, -1],
            [-1, 0, 0, 0, 0, 0, 0, -1],
            [-1, -1, -1, -1, -1, -1, -1, -1]
        ]
    },
    {
        "name": "Map 2",
        "data": [
            [-1, -1, -1, -1, -1, -1, -1, -1],
            [-1, 5, 5, 5, 7, 0, 0, -1],
            [-1, 4, 6, 6, 7, 11, 11, -1],
            [-1, 4, 1, 1, 7, 0, 10, -2],
            [-1, 4, 0, 2, 8, 8, 10, -1],
            [-1, 0, 0, 2, 0, 9, 10, -1],
            [-1, 3, 3, 3, 0, 9, 0, -1],
            [-1, -1, -1, -1, -1, -1, -1, -1]
        ]
    },
    {
        "name": "Map 3",
        "data": [
            [-1, -1, -1, -1, -1, -1, -1, -1],
            [-1, 0, 0, 0, 9, 0, 0, -1],
            [-1, 0, 0, 2, 9, 10, 11, -1],
            [-1, 1, 1, 2, 9, 10, 11, -2],
            [-1, 0, 0, 3, 8, 8, 11, -1],
            [-1, 6, 5, 3, 0, 7, 0, -1],
            [-1, 6, 5, 4, 4, 7, 0, -1],
            [-1, -1, -1, -1, -1, -1, -1, -1]
        ]
    },
    {
        "name": "Map 4",
        "data": [
            [-1, -1, -1, -1, -1, -1, -1, -1],
            [-1, 5, 5, 0, 6, 7, 8, -1],
            [-1, 4, 4, 0, 6, 7, 8, -1],
            [-1, 3, 2, 1, 1, 7, 0, -2],
            [-1, 3, 2, 9, 0, 0, 0, -1],
            [-1, 12, 0, 9, 10, 10, 0, -1],
            [-1, 12, 0, 0, 11, 11, 0, -1],
            [-1, -1, -1, -1, -1, -1, -1, -1]
        ]
    },
    {
        "name": "Map 5",
        "data": [
            [-1, -1, -1, -1, -1, -1, -1, -1],
            [-1, 8, 8, 7, 6, 6, 5, -1],
            [-1, 9, 0, 7, 0, 4, 5, -1],
            [-1, 9, 1, 1, 0, 4, 5, -2],
            [-1, 10, 11, 2, 2, 3, 3, -1],
            [-1, 10, 11, 0, 13, 14, 14, -1],
            [-1, 12, 12, 0, 13, 0, 0, -1],
            [-1, -1, -1, -1, -1, -1, -1, -1]
        ]
    },
    {
        "name": "Map 6",
        "data": [
            [-1, -1, -1, -1, -1, -1, -1, -1],
            [-1, 9, 9, 9, 0, 6, 7, -1],
            [-1, 8, 0, 0, 0, 6, 7, -1],
            [-1, 8, 0, 1, 1, 6, 7, -2],
            [-1, 8, 0, 2, 3, 0, 0, -1],
            [-1, 0, 0, 2, 3, 5, 5, -1],
            [-1, 4, 4, 4, 3, 0, 0, -1],
            [-1, -1, -1, -1, -1, -1, -1, -1]
        ]
    },
    {
        "name": "Map 7",
        "data": [
            [-1, -1, -1, -1, -1, -1, -1, -1],
            [-1,  0,  0,  0,  4,  4, 12, -1],
            [-1, 10,  7,  7,  7,  1, 12, -1],
            [-1, 10,  9,  9,  5,  1, 12, -1],
            [-1,  0, 11,  0,  5,  8,  8, -1],
            [-1,  0, 11,  0,  6,  6,  0, -1],
            [-1,  0,  3,  3,  2,  2,  2, -1],
            [-1, -1, -1, -1, -1, -2, -2, -1]
        ]
    },
    {
        "name": "Map 8",
        "data": [
            [-1, -1, -1, -1, -1, -1, -1, -1],
            [-1, 12,  0, 11, 10, 10, 10, -1],
            [-1, 12,  0, 11,  8,  9,  0, -1],
            [-1,  2,  1,  1,  8,  9,  0, -2],
            [-1,  2,  0,  7,  7,  7,  6, -1],
            [-1,  3,  3,  3,  0,  0,  6, -1],
            [-1,  4,  4,  0,  5,  5,  6, -1],
            [-1, -1, -1, -1, -1, -1, -1, -1]
        ]
    },
    {
        "name": "Map 9",
        "data": [
            [-1, -1, -1, -1, -1, -1, -1, -1],
            [-1,  6,  6,  0,  7,  8,  9, -1],
            [-1,  0,  0,  0,  7,  8,  9, -1],
            [-1,  2,  1,  1,  7,  0, 10, -2],
            [-1,  2,  0,  5, 11, 11, 10, -1],
            [-1,  3,  3,  5,  0,  0, 10, -1],
            [-1,  4,  4,  5,  0,  0,  0, -1],
            [-1, -1, -1, -1, -1, -1, -1, -1]
        ]
    },
    {
        "name": "Map 10",
        "data": [
            [-1, -1, -1, -1, -1, -1, -1, -1],
            [-1, 13, 13, 13, 8, 0, 9, -1],
            [-1, 12, 12, 0, 8, 0, 9, -1],
            [-1, 11, 10, 10, 8, 7, 7, -1],
            [-1, 11, 0, 1, 5, 5, 6, -1],
            [-1, 2, 2, 1, 0, 4, 6, -1],
            [-1, 0, 3, 3, 3, 4, 0, -1],
            [-1, -1, -1, -2, -1, -1, -1, -1]
        ]
    }
]
